{
    "vertexPositions": [
    
    -5,0,0, 5,0,0, 5,0,-1000,
    -5,0,0, 5,0,-1000, -5,0,-1000,

    -1,0,-30, 1,0,-30, 1,4,-30, 
    -1,0,-30, 1,4,-30, -1,4,-30,

    -5,0,-30, -3,0,-30, -3,4,-30, 
    -5,0,-30, -3,4,-30, -5,4,-30,

    3,0,-30, 5,0,-30, 5,4,-30, 
    3,0,-30, 5,4,-30, 3,4,-30,

    -5,4,-30, 5,4,-30, 5,6,-30, 
    -5,4,-30, 5,6,-30, -5,6,-30,

    -5,0,-60, 5,0,-60, 5,1,-60, 
    -5,0,-60, 5,1,-60, -5,1,-60,

    -5,0,-100, 1,0,-100, 1,2,-100, 
    -5,0,-100, 1,2,-100, -5,2,-100,

    -1,0,-120, 5,0,-120, 5,2,-120, 
    -1,0,-120, 5,2,-120, -1,2,-120,

    -5,2,-140, 5,2,-140, 5,4,-140, 
    -5,2,-140, 5,4,-140, -5,4,-140,

    -3,0,-160, -1,0,-160, -1,4,-160, 
    -3,0,-160, -1,4,-160, -3,4,-160,

    1,0,-160, 3,0,-160, 3,4,-160, 
    1,0,-160, 3,4,-160, 1,4,-160,

    -5,4,-160, 5,4,-160, 5,6,-160, 
    -5,4,-160, 5,6,-160, -5,6,-160
    
	],
    "vertexTextureCoords": [0,1],
    "indices": [
    0,1,2,
    3,4,5,

    6,7,8,
    9,10,11,

    12,13,14,
    15,16,17,

    18,19,20,
    21,22,23,

    24,25,26,
    27,28,29,

    30,31,32,
    33,34,35,

    36,37,38,
    39,40,41,

    42,43,44,
    45,46,47,

    48,49,50,
    51,52,53,

    54,55,56,
    57,58,59,

    60,61,62,
    63,64,65,

    66,67,68,
    69,70,71
	],
    "vertexNormals": [
    	0,0,1,
    	0,0,1,

    	0,1,0,
    	0,1,0,

    	0,1,0,
    	0,1,0,

    	0,1,0,
    	0,1,0,

    	0,1,0,
    	0,1,0,

    	0,1,0,
    	0,1,0,

    	0,1,0,
    	0,1,0,

    	0,1,0,
    	0,1,0,

    	0,1,0,
    	0,1,0,

    	0,1,0,
    	0,1,0,

    	0,1,0,
    	0,1,0,

    	0,1,0,
    	0,1,0
    ]
}



    

    

    
